ActionAndNoteCreatedBy=Action and notes created by
ActionAndNotesBelongingToDiffPayorsErrorMsg=Cannot apply actions and notes on claims belonging to different payers.
ActionTypeInActiveNotExistErrMsg=Specified action type with active does not exist. Please select active action type.
ActionTypeNotExistErrMsg=Specified action type does not exist. Please select a valid action type.
AdjustmentPosted=Adjustment posted
AdjustmentPostedAmount=Adjustment posted amount
AdjustmentPostedDate=Adjustment posted date
AgentManagerAuditHistory=Audit history
AgentMeasurement=Agent measurement
AgingDaysLabel=%1 - %2 Days
AllClaimExportMultipleThreadBatchJobs=All claim export multiple thread batch jobs
APIStatusLabel=API status
 ;Staging table Label (Task-18889)
ArchiveClaimDetailsStaging=Archive claim details staging
ArchiveClaimDetailsStagingView=Archive claim details staging view
ArchiveClaimLinesStaging=Archive claim lines staging
ArchiveClaimLinesStagingView=Archive claim lines staging view
ArchiveClaimPaymentPostingsStaging=Archive claim payment postings staging
ArchiveClaimPaymentPostingsStagingView=Archive claim payment postings staging view
AssignmentOfAgeOnZeroClaims=Assignment of age on $0 denied claims
AssignmentOfAgeOnZeroClaimsMultipleThreadTask=Assignment of age on $0 denied claims multiple thread task#%1
AssignmentOfPoolsOnZeroClaims=Assignment of pools on $0 denied claims
AssignmentOfPoolsOnZeroClaimsMultipleThreadTask=Assignment of pools on $0 denied claims multiple thread task#%1
AssignmentOfPriorityOnZeroClaim=Assignment of priority on $0 denied claims
AssignPriority=Assign priority
AssignPriorityToClaimsMultipleThreadBatchJobs=Assign Priority to Claims Multiple Thread Batch Jobs
AssignPriorityToZeroClaimsMultipleThreadBatchJobs=Assign Priority to $0 Denied Claims Multiple Thread Batch Jobs
BatchJobFailMsg=Batch job failed
BatchJobForQualifyZeroDeniedClaims=Batch job for qualification of $0 denied claims
BatchJobForZeroDeniedClaims=Batch job for $0 denied claims
BillingCode=Unit of measurement (billing code)
BillingCodeDescription=Billing code description
CalculateZeroClaimPoolMultipleThreadBatchJobs=Calculate $0 Denied Claim Pool Multiple Thread Batch Jobs
CatchError=An error occurred when updating the record
ChangedByUser=Changed by user
ClaimChangeLog=Claim change log
ClaimChangeLogView=Claim change log view
ClaimCount=Claims count
ClaimDeletionNotAllowedIfPaymentPostingOtherThanTransferExistWarning=Claims cannot be deleted while dependent Claim payment posting other than "Transfer" type exists.
ClaimDetailsStagingArchive=Claim details staging archive
ClaimIdExistsInActionAndNotes=ClaimID exists in action and notes
ClaimLinesStagingArchive=Claim lines staging archive
ClaimLineStagingArchive=Claim details staging archive
ClaimManagerTilesCountsInfo=Claim manager tiles counts information
ClaimNotQualifiedPriorityAssignment=Claim not qualified for new priority assignment
ClaimPaymentPostingsStagingArchive=Claim payment postings staging archive
ClaimPrioritizationCalculatedFields=Claim prioritization calculated fields
ClaimPriorityHistory=Claim priority history
ClaimProcessStatusInActiveNotExistErrMsg=Specified status with active does not exist. Please select active status.
ClaimProcessStatusNotExistErrMsg=Specified status does not exist. Please select a valid status.
ClaimsAssignedToMeAgentView=Claims (agent view)
ClaimsAssignedToMeSupervisorView=Claims (supervisor view)
ClaimsFromMultiplePatientsAreSelectedErrorMsg=Claims from multiple patients are selected.
ClaimsFromMultiplePoolsAreSelectedErrorMsg=Claims from multiple pools are selected.
ClaimsSummary=Claims summary
ClaimsV2StagingArchive=Claims V2 staging archive
ClaimValidFrom=Claim valid from
ClaimValidTo=Claim valid to
ClaimValueNotFoundInTableError=Claim record does not exists against invoice number '%1'  and payor '%2' in related table '%3'
ClearClaimBatchLogs=Clear claim batch logs
CodeorCheque=Code / check #
CompoundCodeDescription=Compound code description
CompoundDisUnitFormDescription=Compound dis unit form description
CompoundDosageFormDescription=Compound dosage form description
CompundTypeDescription=Compund type description
cpk_ncpdpm=cpk_ncpdpm
CreationDateTime=Creation date and time
DataPreparationForAllClaimExportMultipleThreadTask=Data preparation for all claim export multiple thread task#%1 records range %2 -%3
DataPreparationForZeroClaimAgeCalcMultipleThreadTask=Data preparation for $0 denied claim Age calculate multiple thread task#%1 records range %2 - %3
DataPreparationForZeroClaimAging=Data preparation for calculating of aging days for $0 denied claims
DataPreparationForZeroClaimPool=Data preparation for assignment of pool for $0 denied claims
DataPreparationForZeroClaimPriority=Data preparation for assignment of priority for $0 denied claims
DataPreparationForZeroClaimQulaificationMultipleThreadTask=Data preparation for $0 denied claim qualification multiple thread task#%1 records range %2 - %3
DataPreparationForZeroQualification=Data preparation for qualification of $0 denied claims
DateAndTime=Date and time
DaysSinceAdjustmentPosting=Days since adjustment posting
DaysSinceDenialPosting=Days since denial posting
DaysSinceLastActionAndNote=Days since last action and note
DaysSincePaymentPosting=Days since payment posting
DaysToTheNextFollowUpDate=Days to the next follow-up date
DefaultClaimPrirority=Default claim priority
DefaultPriorityAssignmentFailed=Assignment of default priority on claims is failed
DeleteRecord=Can not delete record.
DeleteValidationForHMActionAndNotesTemplates=%1 cannot be deleted. Selected record is associated with one or more Action types.
DenialPosted=Denial posted
DenialPostedAmount=Denial posted amount
DenialPostedDate=Denial posted date
DialogBoxMessage=Pool with sequence number %1 already exists. By doing this action, the sequence of some of the existing pools will change. Do you wish to continue?
DialogBoxUpdate=Pool with sequence %1, %2 already exists. By doing this action, the sequence of some of the existing pools will change. Do you wish to continue?
DirPartyRelationship=Party relationship recid
DispensesAsWrittenDescription=Dispenses as written description
EnabledDateAndTimeLabel=Enabled date time
 ;Field label
ExcludePaymentPosting=Exclude payment posting filter
ExcludePaymentPostingHelpText=No, when utilizing Code/check# search. Yes, when utilizing for all other parameters
FailedToDeleteDataFromTable=Failed to delete data from %1 table
FailedToDeleteDataFromTmpTableAgainstClaim=Failed to delete data from %1 temporary table against the claim %2
FieldValueNotFound=Fields '%1' and '%2' must be filled in
HClaimAgentClaimPreviouslyWorkedOnMaintain=Claim agent claim previously worked on maintain
HClaimAgentClaimPreviouslyWorkedOnView=Claim agent claim previously worked on view
HijriBirthDate=Hijri birth date
HijriExpiryDate=Hijri expiry date
HM=ndc
HMActionAndNotes=Action and notes
 ;Menu item label
HMActionAndNotesHistoryEntityExport=Action and notes history export entity
HMActionAndNotesHistoryInquiry=Action and notes history inquiry
HMActionAndNotesHistoryInquiryDetails=Inquiry details
HMActionAndNotesHistoryInquiryView=Action and notes history inquiry view
HMActionAndNotesHT=View action and notes
 ;Menu item helptext
HMActionAndNotesHTLabel=View action and notes history
 ;Menu item help text
HMActionAndNotesMaintain=Action and notes maintain
HMActionAndNotesTemplateDD=This table holds the data for action and notes templates
 ;Developer documentation (Req-960)
HMActionAndNotesTemplateLabel=Action and notes templates
 ;Table label (Req-960)
HMActionAndNotesTemplateMaintain=Action and notes templates maintain
 ;Security privilege Label (Req-960)
HMActionAndNotesTemplateView=Action and notes templates view
 ;Security privilege Label (Req-960)
HMActionAndNotesView=Action and notes history
 ;Menu item label
HMActionAndNotesViewMaintain=Action and notes history
HMActionNotesRecordValidationErrMsg=Please select at least 1 claim to apply action and notes on
 ;Validation message for action and notes button on other claims
HMActionType=Action type
 ;HMWellSkyAPI
HMActionTypeDD=This table holds the data for action type
 ;Developer documentation
HMActionTypeHT=Specify action type
 ;Field helptext
HMActionTypeLabel=Action type
 ;Table label
HMActionTypeMaintain=Action type maintain
HMActionTypeTableISActiveField=Inactive
 ;HMActionTypeTable
HMActionTypeView=Action type view
HMActiveClaimsByAging=Active claims by aging
HMActiveUserListExportEntity=Active user list
HMActiveUserListExportEntityDoc=This entity fetches enable user id's and their assigned privileges
 ;Developer documentation
HMActiveUserListExportEntityView=Active user list export entity view
HMActiveUserListView=Active user list view
HMAdd=Add
HMAdjudicationHeader=Adjudication header
HMAdjudicationHeaderID=Adjudication header ID
HMAdjudicationLines=Adjudication lines
HMAdjudicationLinesID=Adjudication lines ID
HMAdjudicationReport=Adjudication report
HMAdjudicationResponse=Adjudication response
HMAdjudicationResponseID=Adjudication response ID
HMAgentAllPoolClaimsAging0_30Maintain=Claim agent all pool claims aging 0-30 maintain
HMAgentAllPoolClaimsAging0_30View=Agent all pool claims aging 0_30 view
HMAgentAndManager=Agent and manager
HMAgentDoesnotExistError=Agent does not exist in the pool.
HMAgentFromDifferentPools=Cannot remove agents from claims belonging to different pools
HMAgentManagerAuditLog=Agent and manager audit log
HMAgentOnshoreError=Agent is assigned with pools having is onshore set to yes.
HMAgentRemovedFromClaims=Agent has been removed from the marked records
HmAgentRemovedFromClaimsAlert=Are you sure you want to remove agent from the marked records?
HMALLCALIMEXPORTENITTY=All Claim Export Entity
 ;Label For Data Entity
HMAllClaimExportEntityView=All Claim Export Entity View
 ;Label for All claim Export Entity View Privileges
HMAllClaimExportMultiThreadBatchJobAMI=All claims export reporting entity
 ;Label For All Claim Export Multi Thread Batch Job Action Menu Item
HMAllClaimsInquiry=All claims inquiry
HMAllClaimsInquiryView=All claims inquiry view
HMAllClaimsListPageForClaimAgentView=All claims list page for claim agent view
HMAllClaimsListPageForClaimManagerView=All claims list page for claim supervisor view
HMAllClaimsListPageForClaimSupervisorView=All claims list page for claim supervisor view
HMAllowedAmt=Allowed amount
 ;EDT Label (Task-18889)
HMAmount=Amount ($)
 ;Field label
HMAmountHT=Total amount of claims
 ;Amount field help text
HMAppealDays=Appeal days
 ;EDT label
HMAppealDaysHT=Specify appeal days
 ;Help text EDT
HMArchiveClaimLine=Archive claim lines
HMArchiveClaimLineView=Archive claim lines view
HMArchiveClaimPaymentPosting=Archive claim payment postings
HMAssignedAgentToClaimsForAllClaimsAndClaimDetailsMaintain=Assigned agent to claims for all claims and claim detail maintain
HMAssignedAgentToClaimsMaintain=Assigned agent to claims maintain
HMAssignedPoolToClaimsMaintain=Assigned pool to claims maintain
HMAssignedPriorityToClaimsMaintai=Assigned priority to claims maintain
HMAssignmentType=Assignment type
HMAssignPool=Assign pool
HMAttention=Attention
 ;Field label
HMAttentionClassLabel=ATT:
 ;Label used in class
HMAuthor=Author
 ;HMWellSkyAPI
HMAutoFill=Click here to auto-fill
 ;Button label
HMBatchJobs=Batch jobs
HMBilled=Billed
 ;EDT Label (Task-18889)
HMBilledDescription=Billed description
HMBilledSite=Billed site
HMByHCPC=By HCPC
HMByOrder=By order
HMCall=Call
 ;Enum label
HmChangePriorityStrategy=Change priority strategy
HMChangePriorityStrategyMaintain=Change priority strategy maintain
HMChangeSequence=Change sequence number
HMChangeSequenceMaintain=Change sequence number maintain
HMChargeLineIntegrationUniqueID=Charge line integration unique id
HMCHARGElINENUMBER=Charge line number
HMCheckEFTAmount=Check/EFT amount
 ;EDT Label (Task-18889)
HMCheckEFTDate=Check/EFT date
 ;EDT Label (Task-18889)
HMCheckEFTNumber=Check/EFT #
 ;EDT Label (Task-18889)
HMClaimActionAndNotesMeasurement=Claim actions and notes measurement
HMClaimActionAndNotesView=Claim action and notes view
HMClaimAdminDutyV2=Claim admin duty V2
HMClaimAdminRoleV2=Claim admin V2
HMClaimAgent=Claim agent
HMClaimAgentDutyV2=Claim agent duty V2
HMClaimAgentGoalTrackerMaintain=Goal tracker maintain
HMClaimAgentRoleV2=Claim agent V2
HMClaimAgents=Claim agents and managers
 ;Form Caption (Task-7653)
HMClaimAging0To30Days=0 - 30 Days
HMClaimAmountRelatedToThisCase=Claim amounts related to the case
HMClaimBalance=Claim Balance:
 ;Template label
HMClaimChargeLineArchiveDevDoc=This table is for archiving claim charge lines.
HMClaimChargeLineIntegrationStatusDataEntityLabel=UHC import entity
 ;Data entity Label (Task-18889)
HMClaimChargeLineIntegrationStatusDataEntityMaintainLabel=UHC import entity maintain
 ;Security privilege Label (Task-18889)
HMClaimChargeLineIntegrationStatusDataFormCaptionLabel=UHC status
 ;Form caption label (Task-18889)
HMClaimChargeLineIntegrationStatusDataLabel=UHC Status
 ;Menu item label (Task-18889)
HMClaimChargeLineIntegrationStatusDataTableDevDoc=This table is used to record the data for integration data related to claim lines
 ;Table Dev Doc Label (Task-18889)
HMClaimChargeLineIntegrationStatusDataTableLabel=Claim line integration status data
 ;Table Label (Task-18889)
HMClaimChargeLineIntegrationStatusStaging=UHC Staging Data
 ;Staging table Label (Task-18889)
HMClaimChargeLineStaging=Claim Line Staging Data
 ;Label for form HMClaimChargeLineStaging
HMClaimChargeLineStagingform=Claim charge line staging data
 ;Label for form
HMClaimCreatedBy=Claim created by
HMClaimCreatedDatetime=Claim created datetime
HMClaimDetailsArchive=Claim CMS 1500 archive
HMClaimDetailsStaging=Claim Details Staging Data
 ;Label for form HMClaimDetailsStaging
HMClaimDOS=Claim DOS:
 ;Template label
HMClaimHeaderArchive=Archive claim header
HMClaimHeaderArchiveView=Archive claim header view
HMClaimHeaderRawDataMeasurement=Claim header raw data measurement
HMClaimHeaderRawDataView=Claim header raw data view
HMClaimID=Claim ID
 ;HMWellSkyAPI
HMClaimLineArchive=Claim lines archive
HMClaimLineRawDataMeasurement=Claim line raw data measurement
HMClaimLinesFormCaptionLabel=Claim lines
 ;Form caption label (Task-18889)
HMClaimManagerAllPoolsClaimAging0_30Maintain=Claim manager all pools claim aging 0_30 maintain
HMClaimManagerAllPoolsClaimAging0_30View=Claim manager all pools claim aging 0_30 view
HMClaimManagerAllPoolsClaimsAging0_30Maintain=Claim aging 0_30 maintain
HMClaimManagerClaimsWithNoActionsOrNoteMaintain=Claim manager claims with no actions or note maintain
HMClaimManagerClaimsWithNoActionsOrNoteView=Claim manager claims with no actions or note view
HMClaimManagerDutyV2=Claim manager duty V2
HMClaimManagerNoActivityClaimsMaintain=No activity claims maintain
HMClaimManagerNoNotesClaimsMaintain=No notes claims maintain
HMClaimManagerNoNotesClaimsView=No notes claims view
HMClaimManagerofNext7DaysFollowUpDateMaintain=Claim manager of next 7 days followup date maintain
HMClaimManagerRoleV2=Claim manager V2
HMClaimManagerWithNoActionsOrNoteMaintain=Claim manager with no actions or note maintain
HMClaimModifiedBy=Claim modified by
HMClaimModifiedDateTime=Claim modified datetime
HMClaimNotesEntityMaintain=Claim notes entity maintain
HMClaimNotesEntityView=Claim notes entity view
HMClaimNumber=Claim number
 ;Field Label (Task-18889)
HMClaimPaymentDate=Date posted
HMClaimPaymentPosting=Claim payment posting
HMClaimPaymentPostingArchive=Claim payment posting archive
HMClaimPaymentPostingArchiveDevDoc=This table is for archiving claim payment postings.
HMClaimPaymentPostingArchiveView=Claim payment posting archive view
HMClaimPaymentPostingEntity=Claim payment posting
HMClaimPaymentPostingMeasurement=Claim payment posting measurement
HMClaimPaymentPostingStaging=Claim payment posting staging data
 ;Label for form HMClaimPaymentPostingStaging
HMClaimPaymentPostingType=Type
HMClaimPaymentPostingView=Claim payment posting view
HMClaimPayorError=No claim on this payor
HmClaimPool=Claim pool
HMClaimPostingInquiry=Claim posting inquiry
HMClaimPostingInquiryView=Claim posting inquiry view
HMClaimPostingTab=Claim postings
HMClaimPreviouslyWorkedOn=Claims closed in last 60 days
HMClaimPrioritizationCalculatedFieldsDevDoc=RCM table to store the temporary calculated field for Prioritization batch job
HMClaimPriorityChangeLog=%1%2
HMClaimPriorityHistoryView=Claim  priority history view
HMClaimProcessStatusEntityMaintain=Claim process status entity maintain
HMClaimProcessStatusEntityView=Claim process status entity view
HMClaimProcessStatusISACtiveField=Inactive
 ;HMClaimProcessStatus
HMClaimResponsible=Claim responsible
HMClaimResponsibleHT=Different responsibilities of claim
HMClaimsAssignedToMyAgents=Claims assigned to my team
HMClaimsByPools=Claims by pools
HMClaimsInPoolsAssignedToMe=Claims in pools assigned to me
HMClaimsofNext7DaysFollowUpDateMAintain=Next 7 days follow up date maintain
HMClaimsSupervisorofLast30DaysWithNotesorAction=Last 30 days with notes or action
HMClaimsSupervisorofNext7DaysFollowUpDate=Next7DaysFollowUpDate
HMClaimsSupervisorWithNoActionsOrNoteMaintain=Claim supervisor with no actions or note maintain
HMClaimStatus=Claim status
 ;EDT Label (Task-18889)
HMClaimSummaryAmountMaintain=Claim summary amount maintain
HMClaimSupervisor=Claim supervisor
HMClaimSupervisorActionsDueTodayMaintain=Actions due today maintain
HMClaimSupervisorActiveClaimsByPayorMaintain=Active claims by payor maintain
HMClaimSupervisorActiveClaimsMaintain=Active claims maintain
HMClaimSupervisorAllPoolClaimsAging0_30Maintain=Claim aging 0 to 30 maintain
HMClaimSupervisorClaimPreviouslyWorkedOnMaintain=Claim previously worked on maintain
HMClaimSupervisorClaimsByPoolMaintain=Claims by pool maintain
HMClaimSupervisorClaimsWithNoAgentAssignedByAgingMaintain=Claims with no agent assigned by aging maintain
HMClaimSupervisorDutyV2=Claim supervisor duty V2
HMClaimSupervisorMyActionsMaintain=My actions maintain
HMClaimSupervisorMyRecentNotesMaintain=My recent notes maintain
HMClaimSupervisorRoleV2=Claim supervisor  V2
HMClaimSupervisorViewActiveClaimsByAgingMaintain=Active claims by aging maintain
HMClaimSupervisorWorkspaceMaintain=Claim supervisor workspace maintain
HMClaimsWithNoAssignedAgent=Claims with no assigned agent
 ;Label for ClaimsWithNoAssignedAgent (Tab Page)
HMClaimsWithNotesOrAction=Claims with  actions and notes (last 30 days)
HMClaimTableArchive=Claim archive
HMClaimTableArchiveDevDoc=This table is archiving claims.
HMClaimTableDetailsArchiveDevDoc=This table is for archiving claim CMS 1500.
HMClaimTableDetailsV2DevDoc=The HMClaimTableDetailsV2Entity data entity contains the information about claim details
HMClaimTableDetailsV2Entity=Claims V2
HMClaimTableIntegrationStatusDataEntityLabel=Waystar import entity
 ;Data entity Label (Task-18889)
HMClaimTableIntegrationStatusDataEntityMaintainLabel=Waystar import entity maintain
 ;Security privilege Label (Task-18889)
HMClaimTableIntegrationStatusDataFormCaptionLabel=Waystar status
 ;Form caption label (Task-18889)
HMClaimTableIntegrationStatusDataLabel=Waystar Status
 ;Menu item label (Task-18889)
HMClaimTableIntegrationStatusDataTableDevDoc=This table is used to record the data for integration data related to claim table
 ;Table Dev Doc Label (Task-18889)
HMClaimTableIntegrationStatusDataTableLabel=Claim table integration status data
 ;Table Label (Task-18889)
HMClaimTableIntegrationStatusDataViewLabel=Waystar status view
 ;Security privilege Label (Task-18889)
HMClaimTableIntegrationStatusStaging=Waystar Staging Data
 ;Staging table Label (Task-18889)
HMClaimTableMeasurementV2=Claim Measurement V2
HMClaimTablePBMUBO4Details=Claim table PBM_UBO4 details
HMClaimTablePBMUBO4DetailsDD=MazikCare table to store details for PBM and UBO4 claim
HMClaimTableSetupEntityMaintain=Claim table setup entity maintain
HMClaimTableSetupEntityView=Claim table setup entity view
HMClaimTotals=Claim totals
HMClaimTotalsRelatedToThePayor=Claim totals related to the payor
HMClaimTotalsView=Claim totals view
HMClaimTypeHT=Different types of claims
HMClaimVersionArchive=Claim version archive
HMClaimVersionArchiveDevDoc=This table is for archiving claim version.
HMClaimVersionValidFrom=Version valid from
HMClaimVersionValidTo=Version valid to
HMClaimWithNOActionsAndNotesSevenPlusDays=Claims with no actions and notes 7+ days
HMCMS1500=CMS 1500
HMCodeChequeHT=help text for code cheque
HMCoinsurance=Co-insurance
 ;EDT Label (Task-18889)
HMCompoundCode=Compound code
HMCompoundDisUnitForm=Compound dis unit form
HMCompoundDosageForm=Compound dosage form
HMCompoundInformation=Compound information
HMCompundType=Compound type
HMConnectionString=Connection string
HMCopayField=Co-pay
 ;EDT Label (Task-18889)
HMCopyPriority=Copy priority
HMCopyPriorityCaption=Please fill out the following priority header fields. Priority criteria would be copied from %1%2.
HMCost=Cost
HMCoversPeriodDays=Covers period days
HMCoversPeriodFrom=Covers period from
HMCoversPeriodThrough=Covers period through
HMcpk_Ncpdpreps=cpk_Ncpdpreps
HMCPRResearch=CPR + Research
 ;Enum label
HMCreateCustCollectionPool=Create new pool
 ;Menu item label
HMCreateCustCollectionPoolMaintain=Create new pool maintain
HMCreatedBy=Created by:
 ;Template label
HMCreatedDate=Created date:
 ;Template label
HMCreatedDateandTime=Created date and time
 ;HMWellSkyAPI
HMCSClaimAging30To60DaysMaintain=Claim aging 30 to 60 days maintain
HMCSClaimAging61To90DaysMaintain=Claim aging 61 to 90 days maintain
HMCSTCreatedDateAndTime=CST created date and time
HMCustCollectionPoolView=Cust collections pool view
HMCustCollectionsPoolEntity=Optum cust collections pool entity
 ;Entity Label
HMCustCollectionsPoolMaintain=Claim collections pool maintain
HMCustCollectionsPoolView=Claim collections pool view
HMDate=Date
HMDateFilledDOS=Date filled aka DOS
HMDatePosted=Date posted
HMDateRxWritten=Rx date
HMDaysSinceDenialPosting=Days since last denial posted
HMDaysSupply=Days supply
HMDecisionBasedOn=Decision based on:
 ;Template label
HMDecisionBasedOnLabel=Decision based on
 ;Enum label
HMDedAmt=Ded amount
 ;EDT Label (Task-18889)
HMDeleteSequence=You are about to delete a pool %1. This will lower the sequence number of some of the pools. Do you wish to continue?
HMDelflag=Delflag
HMDeniedReason=Denied reason:
 ;Template label
HmDeniedZeroClaimMainBatchJobMaintain=Batch job for $0 denied claims maintain
 ;Label
HmDeniedZeroClaimMainBatchJobMenuItemLabel=Batch job for $0 denied claims
HMDirPartyRelationshipView=Party relationship view
 ;View label
HMDisablePersonFromUser=Disable person from user
HMDisablePersonFromUserDD=Disable person from user developer documentation
HMDisAllowedAmt=Disallowed amount
 ;EDT Label (Task-18889)
HMDispensesAsWritten=Dispenses as written
HMDOPharmacy=D.0/Pharmacy
HMDOS=DOS
 ;EDT Label (Task-18889)
HMDrugName=Drug name
HMDuplicateKeyErrorMessage=Cannot create a record in %1 (%2). %3: %4, %5: %6. The record already exists.
HMEmptyText=None
HMEndTime=End time
 ;HMPoolAndPrioritySummaryRpt column label
HMErrorLog=Error log
HMFailedClaims=Failed claims
 ;HMPoolAndPrioritySummaryRpt column label
HMFeeBilled=Fee billed
HMFeeDiscount=Fee discount
HMFeeDiscountPercent=Fee discount percent
HMFeePaid=Fee paid
HMFeeScheduleName=Fee schedule name
HMFieldDescription=Field description
HMFieldName=Field name
HMFollowUpDate=Next follow-up date
 ;Field label
HMFollowUpDateHT=Specify next follow-up date
 ;field label help text
HMFollowupDateWS=Follow-up date
 ;HMWellSkyAPI
HMFollowUpDays=Follow-up days
 ;Field label
HMFollowUpDaysHT=Specify number of days
 ;Field help text
HMFreeScheduleName=FeeScheduleName
HMFromDate=From date
HMFromPool=From pool
HMHeaderTableDev=Adjudication table to store adjudication header details
HMHTTPStatus=HTTP status
 ;HMWellSkyAPI
HMICDcodesMaintain=ICD codes maintain
HMICDcodesView=ICD codes view
HMICNNo=ICN no #
 ;Field label
HMICNNoHT=Specify ICN number
 ;Field helptext
HMInactive=Inactive
 ;Field label
HMInactiveDate=Inactive date
 ;Field label
HMInactiveDateHT=Specify Inactive date
 ;Field help text
HMInactiveHT=Specify inactive
 ;Field help text
HMIngrCostBilled=Ingr cost billed
HMIngrCostDiscount=Ingr cost discount
HMIngrCostDiscountPercent=Ingr cost discount percent
HMIngrCostPaid=Ingr cost paid
HMInstitutional=UBO4/Institutional
HMInsuranceCoordinator=HMInsuranceCoordinator
HMInsuranceCoordinatorForm=Insurance coordinator
HMIntegrationStatusDescription=Description
 ;EDT Label (Task-18889)
HMIntegrationStatusEntityLabel=Waystar/UHC status master import entity
 ;Data entity Label (Task-18889)
HMIntegrationStatusEntityMaintainLabel=Waystar/UHC status entity maintain
 ;Security privilege Label (Task-18889)
HMIntegrationStatusFormCaption=Waystar/UHC status
 ;Form caption Label (Task-18889)
HMIntegrationStatusMaintainLabel=Waystar/UHC status maintain
 ;Security privilege Label (Task-18889)
HMIntegrationStatusMenuItem=Waystar/UHC status
 ;Menu item Label (Task-18889)
HMIntegrationStatusMenuItemHelpText=Set up Waystar/UHC status
 ;Menu item helptext Label (Task-18889)
HMIntegrationStatusName=Status
 ;EDT Label (Task-18889)
HMIntegrationStatusTableDevDoc=This table is used to store Waystar/UHC statuses
 ;Table Dev Doc Label (Task-18889)
HMIntegrationStatusTableLabel=Waystar/UHC status
 ;Table Label (Task-18889)
HMIntegrationStatusType=Status Type
 ;EDT Label (Task-18889)
HMIntegrationStatusTypeDenial=Denial
 ;Enum element Label (Task-18889)
HMIntegrationStatusTypeNone=None
 ;Enum element Label (Task-18889)
HMIntegrationStatusTypePayment=Payment
 ;Enum element Label (Task-18889)
HMIntegrationStatusViewLabel=Waystar/UHC status view
 ;Security privilege Label (Task-18889)
HMIntegrationUniqueID=Integration unique id
 ;EDT Label (Task-18889)
HMInvoiceNumber=Invoice number
 ;EDT Label (Task-18889)
HMInvoiceTypeHT=Specify invoice type
 ;Help text payer invoice type field
HMInvoiceTypeTableMaintain=Invoice type table maintain
HMInvoiceTypeTableView=Invoice type table view
HMIsConsiderForZeroDeniedClaims=Consider for $0 denied claims
 ;Field label
HMIsCurrency=Is currency
HMIsManager=Is manager
 ;Enum Label (Task-7653)
HMIsManagerHT=Specify manager
 ;Enum Help Text (Task-7653)
HMIsSkipClaims=Skip claims if agent is already assigned
HMItemOrServiceCode=Item/service code
 ;EDT label
HMItemOrServiceCodeHT=Specify item or service code
 ;EDT helptext
HMJobId=Job ID
 ;HMPoolAndPrioritySummaryRpt column label
HMJobStatus=Job status
 ;HMPoolAndPrioritySummaryRpt column label
HMJobType=Job type
 ;HMPoolAndPrioritySummaryRpt column label
HMLastNoteDateTime=Last note date and time
 ;Label for notes date and time field on claim table
HMLastPostingCodes=Last Posting Codes
HMLatestResponse=Latest response
 ;EDT Label (Task-18889)
HMLengthError=The value specified %1 is not equal to required field length of %2 digits for %3. Please enter a value that is equal to %4 digits.
HMLineNbr=Line number
 ;EDT Label (Task-18889)
HMLineNumber=Line number
HMLinesTableDev=Adjudication table to store adjudication lines details
HMManager=Manager
 ;EDT Label (Task-7654)
HMManagerHT=Specify manager
 ;EDT Help Text (Task-7654)
HMManagerName=Manager name
 ;Entity Field Label
HmManagerNotExistErrMsg=Specified manager does not exists. Please select a valid manager.
HMManagerPartyNumber=Manager party number
 ;Entity Field Label
HMMargin=Margin
HMMessageRetryCount=Message retry count
 ;HMWellSkyAPI
HMMessageSent=Message sent
 ;HMWellSkyAPI
HMNameOfFeeSchedule=Name of fee schedule
HMNDC=NDC
HMNetworkID=Network ID
 ;EDT Label (Task-7651)
HMNetworkIDHT=Specify network id
 ;EDT Help Text (Task-7651)
HMNewRefillCode=New / refill code
HMNewValue=New value
HMNonnumericError=Please enter numeric value for %1.
HMNotes=Notes
 ;HMWellSkyAPI
HMNotesAndActionEntity=Actions and notes
 ;Entity label
HMOldValue=Old value
HMOpenClaimsHT=Total number of claims
 ;Help text EDT
HMOtherClaimsOfThePatient=Other claims of the patient with same payor
HMOtherCoverageCode=Other coverage code
HMOutboundInactivityFeedEntity=Outbound Inactivity Feed
HMOutboundInactivityFeedEntityDevDoc=This entity fetch user id which is not active more than 90 days
 ;Developer documentation
HMOutboundInactivityFeedEntityView=Outbound inactivity feed entity view
HMOutboundInactivityFeedView=Outbound inactivity feed view
HMPaidAmt=Paid amount
 ;EDT Label (Task-18889)
HMPaidToProviderAmt=Paid to provider amount
 ;EDT Label (Task-18889)
HMPatientClaimsMaintain=Patient claims maintain
HMPatientClaimsView=Patient claims view
HMPatientContactInfoMaintain=Patient contact info maintain
HMPatientInsurancePrimaryId=Patient insurance primary id
HMPatientInsuranceStaging=Patient insurance staging data 
 ;Label for form HMPatientInsuranceStaging
HMPatientManagementPortalLinkView=Patient portal view
HMPatientPortal=Patient portal
HMPatientPortalHelpText=Navigates to patient management portal
HMPatientPortalLink=Patient management portal link
HMPatientPortalLinkHelpText=Contains the patient management portal link
HMPatientPortalUnavailable=URL to the patient management portal missing in the parameters.
HMPatientRespAmt=Patient resp amount
 ;EDT Label (Task-18889)
HMPatientSite=HMSite
HMPatientsStatus=Patient status
HMPatientStaging=Patient staging data 
 ;Label for form HMpatientstaging
HMPayerAuthorization=Payer authorization
HMPayerAuthorizationHT=Authorization of different payer
HMPayerAuthorizationRequired=Payer authorization required
HMPayerChat=Payer chat
 ;Enum label
HMPayerDescription=Description
 ;EDT Label (Task-7651)
HMPayerDescriptionHT=Specify the description
 ;EDT Help Text (Task-7651)
HMPayerName=Name
 ;EDT Label (Task-7651)
HMPayerNameHT=Specify payer type
 ;EDT Help Text (Task-7651)
HMPayerNameLabel=Payer name:
 ;Template label
HMPayerStaging=Payer staging data
 ;Label for form HMPayerStaging
HMPayerType=Payer type
 ;Table Label  (Task-7651)
HMPayerTypeDD=This table hold the data for payer type
 ;Table Developer Documentation (Task-7651)
HMPayerTypeMaintain=Payer type maintain
 ;Security Privilege (Task-7651)
HMPayerTypeTableEntityMaintain=Payer type table entity maintain
HMPayerTypeTableEntityView=Payer type table entity view
HMPayerTypeView=Payer type view
 ;Security Privilege (Task-7651)
HMPayorClaimsMaintain=Payor claims maintain
HMPayorClaimsView=Payor claims view
HMPersonCode=Person code
HMPharmacyIdentifier=Pharmacy Identifier
HMPharmacyServiceType=Pharmacy service type
HMPlaceOfResidence=Place of residence
HMPlaceOfServiceTableEntityMaintain=Place of service table entity maintain
HMPlaceOfServiceTableEntityView=Place of service table entity view
HMPolicyGroup=Policy group
HMPolicyOwner=Policy owner
HMPolicyOwnerHT=Specify policy owner
 ;EDT Help Text (Task-7731)
HMPoolAndPrioritySummaryRpt=Batch summary report
HMPoolGridChange=Pool grid change
HMPoolName=Value
HMPOSTINGLINENUMBER=Posting line number
HMPrescriberCompoundInformation=Prescriber / Compound information
HMPrescriberID=Prescriber ID
HMPrescribingPhysican=Prescribing physican
HMPrescribingPhysician=Prescribing physician
HMPrescriptionInformation=Prescription information
HMPrescriptionNumber=Prescription number
HMPrioritySequenceNumber=Priority/Sequence number
HMPriorityStrategy=Priority strategy
HMPriorityStrategyDeletion=Strategy can not be deleted. Selected strategy is assigned to Claim priority or Claim pool.
HMPriorityStrategyDescription=Description
HMPriorityStrategyDevDoc=Optum table to store claim priority strategy
HMPriorityStrategyEntity=Priority strategy entity
HmPriorityStrategyExistSeqNumErrMsg=The record of priority strategy %1 already exists aginst the sequence number %2.
HMPriorityStrategyID=Strategy ID
HMPriorityStrategyIDNotExistErrMsg=Specified priority strategy does not exists. Please select a valid priority strategy.
HMPrivilegeErrorLogMaintain=Privilege error log maintain
HMPrivilegeErrorLogView=Privilege error log view
HMProcedureModifierTmp=Modifier
HMProcessedClaims=Processed claims
 ;HMPoolAndPrioritySummaryRpt column label
HMProcessedDate=Processed date
 ;EDT Label (Task-18889)
HMProductServiceIDQualifier=Product / service ID qualifier
HMProfit=Profit
HMQualifiedClaims=Qualified claims
 ;HMPoolAndPrioritySummaryRpt column label
HMQuantityMetric=Quantity metric
HMQuantityPrescribed=Quantity prescribed
HMQueueName=Queue name
HMReason=Claim pool change reason
HMReasonCode=Reason code
HMReasonHistory=Claim pool change history
HMReasonName=Reason
HMReassignPoolToClaims=Reassign pool to claims
HmRecentNotes=Recent notes
HMReferringProviderName=Referring provider name
HMRefillsPresecribed=# Refills presecribed
HMRegion=Region
 ;Table Label  (Task-7651)
HMRegionDD=This table hold the data for region
 ;Table Developer Documentation (Task-7651)
HMRegionHT=Specify region
 ;EDT Help Text (Task-7651)
HMRegionTableEntityMaintain=Region table entity maintain
HMRegionTableEntityView=Region table entity view
HMRegionTypeMaintain=Region maintain
 ;Security Privilege (Task-7651)
HMRegionTypeView=Region view
 ;Security Privilege (Task-7651)
HMReimbursement=Reimbursement
HMRelatedClaimPrioritizationHelpText=Used to turn on auto agent assignment of similar claims as selected via workspaces.
HMRelatedClaims=Related claims
HMRelatedPools=Related pools
HMRelatedPriorities=Related priorities
HMRelationShip=Primary contact relation
 ;Label
HMRelationshipCode=Relationship code
HMRelationshipMaintain=Relationship maintain
HMRemarkCode=Remark code
 ;EDT Label (Task-18889)
HMRemarkCode1=Remark code 1
 ;EDT Label (Task-18889)
HMRemarkCode2=Remark code 2
 ;EDT Label (Task-18889)
HMRemarkCode3=Remark code 3
 ;EDT Label (Task-18889)
HMRemarkCode4=Remark code 4
 ;EDT Label (Task-18889)
HMRemarkCode5=Remark code 5
 ;EDT Label (Task-18889)
HMRemove=Remove
HMRemoveAgent=Remove agent
HMResetModifiedPoolClaims=Unassign claims from modified pools
HMResetModifiedPoolClaimsBatchJobMaintain=Reset modified pool claims batch job maintain
HMResonDescription=Description
HMResponse=Response
HMResponseCode=Code
HMResponseData=Response data
HMResponseDetails=Response details
HMResponseMessage=Response message
 ;HMWellSkyAPI
HMResponseReceivedDatetime=Response received datetime
HMResponseTableDev=Adjudication table to store adjudication response details
HMResponsibleGroup=Responsible group
HMResponsibleGroupsHT=Specify responsible groups
 ;Field help text
HMResponsibleGroupsTableEntityMaintain=Responsible groups table entity maintain
HMResponsibleGroupsTableEntityView=Responsible groups table entity view
HMRestricted=Restricted
 ;Field label
HMRestrictedHT=Specify restricted or not
 ;Field help text
HMRevenueCategoryTableEntityMaintain=Revenue category table entity maintain
HMRevenueCategoryTableEntityView=Revenue category table entity view
HMRouteOfAdministration=Route of administration
HMRxOriginCode=Rx origin code
HMSelectAgentToAssign=Please select agent to assign
HMSERVICEFROMDATE=Service from date
HMServiceReferenceNo=Service reference number
 ;Field label
HMServiceReferenceNoHT=Specify service reference number
 ;Field helptext
HMServiceStartDate=Service date start
 ;Field Label (Task-18889)
HMSERVICETODATE=Service to date
HMShowCases=Show cases
HMShowClaims=Show claims
HMSite=Site
 ;Field label
HMSiteDD=This table hold the data for site
 ;Table Developer Documentation (Task-7746)
HMSiteHT=Specify site
 ;Field help text
HMSiteMaintain=Site maintain
HMSiteTableEntityMaintain=Site table entity maintain
HMSiteTableEntityView=Site table entity view
HMSiteView=Site view
HMStartOfCare=Start of care
HMStartTime=Start time
 ;HMPoolAndPrioritySummaryRpt column label
HMStatus=HMStatus
HMStatusCode=Status code
 ;Field Label (Task-18889)
HMStringConcat=%1%2
HMSummaryAmountView=Summary amount view
HMSupervisor=Supervisor
 ;EDT Label (Task-7653)
HMSupervisorAllPoolAssignedClaimListPage=All pool assigned claim list page maintain
HMSupervisorAllPoolClaimListPageMaintain=All pool claim list page maintain
HMSupervisorAllPoolClaimsAging120AboveMaintain=Claims aging 120 above maintain
HMSupervisorAllPoolClaimsAging30_60Maintain=Claims aging 30_60 maintain
HMSupervisorAllPoolClaimsAging60_90=Claims aging 60_90 maintain
HMSupervisorAllPoolClaimsAging90_120Maintain=Claims aging 90_120 maintain
HMSupervisorAllPoolUnAssignedClaimListPageMaintain=All pool unassigned maintain
HMSupervisorEntityFieldLabel=Supervisor name
 ;Entity field label
HMSupervisorHT=Specify supervisor
 ;EDT Help Text (Task-7653)
HMSupervisorPartyNumber=Supervisor party number
 ;Entity field label
HMSVCCode=SVC code
 ;EDT Label (Task-18889)
HMTaxID=Tax ID
HMTaxIDHelpText=9 digits Tax Id
HMTemplate=Template
 ;Form tabpage label (Req-960)
HMTemplateDescription=Template Description
 ;Field Label (Req-960)
HMTemplateID=Template ID
 ;Field Label (Req-960)
HMTemplateText=Template Text
 ;Field Label (Req-960)
HMTerminationDate=HMTerminationDate
HMTerminationDateForm=Termination date
HMTherapyType=Therapy type
HMTherapyTypeTableEntityMaintain=Therapy type table entity maintain
HMTherapyTypeTableEntityView=Therapy type table entity view
HMThirdParty=3rd party
HMTimelyFillingDays=Timely filing days
 ;Field label
HMToDate=To date
HMToPool=To pool
HMTotalBilled=Total billed
HMTotalChargeAmount=Total charges
 ;Field Label (Task-18889)
HMTotalDiscount=Total discount
HMTotalDiscountPercent=Total discount percent
HMTotalExpectedAmount=Total expected amount
HMTotalPaid=Total paid
HMTRANSNO=Trans No
HMType=Type
HMTypeOfBill=Type of bill
HMUB04=UB04
HMUB04Source=UB04 source
HMUB04Type=UB04 type
HMUB04TypeDescription=UB04 type description
HMUBO4Institutional=UB-04/Institutional
HMUHCStatusFormCaptionLabel=UHC status data
 ;Form caption label (Task-18889)
HMUnableToUpdateRecord=Unable to update record for %1%2
HMUnassignClaimsFromDisabledUsers=Unassign claims from disabled users
HMUnAssignClaimsFromDisabledUsersMaintain=Unassign claims from disabled users maintain
HMUnitDoseIndictator=Unit dose indictator
HMUnits=Units
 ;EDT Label (Task-18889)
HMUpdateFailForRemoveAgent=An error occurred while updating the record.
HMUploadFileDialogMaintain=Upload file dialog maintain
HMUser=User
HMUserCreatedBy=Created by
HMUserInfoDD=This table is used to record user enabled date time
 ;Developer documentation
HMUserInfoLabel=Enabled user info
 ;Table label
HMWebsiteResearch=Website research
 ;Enum label
HMWellSkyAPI=Wellsky API
 ;HMWellSkyAPI
HMWellSkyAPIBatchError=Failed to send data to service bus for %1
 ;HMWellSkyAPI
HMWellSkyAPIBatchJob=Wellsky API batch job
 ;HMWellSkyAPI
HMWellSkyAPIDataRequest=Wellsky API request
 ;HMWellSkyAPI
HMWellSkyAPIDataResponse=Wellsky API response
 ;HMWellSkyAPI
HMWellSkyAPILogs=Wellsky API logs
 ;HMWellSkyAPI
HMWellSkyAPIRequest=Wellsky API request
 ;HMWellSkyAPI
HMWellSkyAPIRequestDataEntity=Wellsky API request data entity
HMWellSkyAPIRequestDevDoc=This table contains the data for Well sky API requests
 ;HMWellSkyAPI
HMWellSkyAPIResponse=Wellsky API response
 ;HMWellSkyAPI
HMWellSkyAPIResponseDataEntity=Wellsky API response data entity
 ;HMWellSkyAPI
HMWellSkyAPIResponseDevDoc=This table contains the data for Well sky API responses
 ;HMWellSkyAPI
HMWellSkyAPIResponseMaintainEntity=Maintain Wellsky API response data entity
 ;HMWellSkyAPI
HMWellSkyAPIResponseStatusFailed=Failed
 ;HMWellSkyAPI
HMWellSkyAPIResponseStatusSuccess=Success
 ;HMWellSkyAPI
HMWellSkyAPIResponseViewEntity=View Wellsky API response data entity
 ;HMWellSkyAPI
HMWellskyConnectionString=Wellsky connection string
HMWellskyMessageRetryCount=Wellsky message retry count
HMWellskyQueuename=Wellsky queue name
HMWithholdAmt=Withhold amount
 ;EDT Label (Task-18889)
HMZeroClaimBatchJobStatusDevDocumentationLabel=This table is used to save the status of $0 denied batch jobs
HMZeroClaimBatchJobStatusTableLabel=$0 Claim batchjob status
InquiryFormEmptyFilterWarning=At least 1 filter criteria must be filled in.
 ;Error message for inquiry forms
IntegrationClaimDoesNotExists=The claim '%1' does not exists.
IntegrationClaimID=Claim #
IntegrationStagingDataViewPrivilege=Integration staging data view
 ;Label for Privilege (Task-18889)
IsAgingCompletedFieldLabel=Is aging completed
IsClaimDeleted=Is claim deleted
IsClaimPriorityManual=Is claim priority manual
IsDeniedEligible=Is denied eligible
IsJobFinished=Job finished
IsPoolAssignmentCompletedFieldLabel=Is pool assignment completed
IsPoolModified=Is pool modified
IsPriorityCompletedFieldLabel=Is priority completed
LastActionAndNoteCreatedDate=Last action and notes created date
LineSequenceNumber=Line sequence number
LogisticsContactInfoGridMaintain=Logistics contact info grid maintain
LogisticsContactInfoGridView=Logistics contact info grid view
MAZOPT0001=Therapy Type
 ;Therapy Type table title.
MAZOPT0002=Therapy Type developers documentation
 ;Developers documentation.
MAZOPT0003=Details
 ;Details common label.
MAZOPT0004=Therapy types
 ;Menu item label.
MAZOPT0005=Invoice type
 ;Invoice type table title.
MAZOPT0006=Invoice type developers documentation
 ;Developers documentation.
MAZOPT0007=Invoice types
 ;Menu item label.
MAZOPT0008=Billed Sites
 ;Table title.
MAZOPT0009=Information regarding billed sites
 ;Developers documentation.
MAZOPT0010=Billed sites
 ;Menu item label.
MAZOPT0011=Responsible groups
 ;Responsible group table and menu item display
MAZOPT0012=Information regarding HMResponsible group table
 ;Developers documentation.
MAZOPT0013=Responsible Group
 ;Form field label
MAZOPT0014=HM billed sites list page maintain
MAZOPT0015=HM billed sites list page view
MAZOPT0016=HM therapy type list page maintain
MAZOPT0017=HM therapy type list page view
MAZOPT0018=HM invoice type list page maintain
MAZOPT0019=HM invoice type list page view
MAZOPT0020=HM responsible groups list page maintain
MAZOPT0021=HM responsible groups list page view
MAZOPT0022=Is restricted
 ;Field label.
MAZOPT0023=Is onshore
 ;Field label.
MAZOPT0024=Amount paid
MAZOPT0025=Revised amount
MAZOPT0026=Expected amount
MAZOPT0027=Balance amount
MAZOPT0028=Membership Id
MAZOPT0029=Date of visit
MAZOPT0030=Code 1
MAZOPT0031=Code 2
MAZOPT0032=Code 3
MAZOPT0033=Code 4
MAZOPT0034=Carrier name
MAZOPT0035=Carrier code
MAZOPT0036=Insured ext.
MAZOPT0037=Insured plan name or program name
MAZOPT0038=Insured policy group or FECA number
MAZOPT0039=Invoice number
MAZOPT0040=Patient relationship to insured
MAZOPT0041=Name
MAZOPT0042=NPI
MAZOPT0043=Qualifier
MAZOPT0044=Qualifier value
MAZOPT0045=Pharmacy site
MAZOPT0046=Remit to site
MAZOPT0047=Date of injury
MAZOPT0048=CMN
MAZOPT0049=Status
MAZOPT0050=Status description
MAZOPT0051=Billed date
MAZOPT0052=Responsible
MAZOPT0053=Patient address
MAZOPT0054=Claim process status
MAZOPT0055=Claim process status information
MAZOPT0056=Charge line amount
MAZOPT0057=Total paid
MAZOPT0058=Balance
MAZOPT0059=Adjusted amount
MAZOPT0060=NDC
MAZOPT0061=NDC Qualifier
MAZOPT0062=NDC Units
MAZOPT0063=HCPC
MAZOPT0064=Description of charges
MAZOPT0065=Revenue category
MAZOPT0066=Rx No.
MAZOPT0067=Authorization
MAZOPT0068=Code / Check #
MAZOPT0069=Revenue categories
MAZOPT0070=HM Claim Process Status list page maintain
MAZOPT0071=HM Claim Process Status list page view
MAZOPT0072=HM Revenue Category list page maintain
MAZOPT0073=HM Revenue Category list page view
MAZOPT0074=Claim priority
MAZOPT0075=Optum table to store claim priority
MAZOPT0076=Priority can not be deleted because it is assigned to a claim.
MAZOPT0077=Claim priority criteria
MAZOPT0078=Select claim priority criteria
MAZOPT0079=HM claim priority table maintain
MAZOPT0080=HM claim priority table view
MAZOPT0081=Priority description
MAZOPT0082=Assign priority to claims
MAZOPT0083=Service to date
MAZOPT0084=Service from date
MAZOPT0085=Date of service start
MAZOPT0086=Date of service end
MAZOPT0087=Total charge amount
MAZOPT0088=Payor site
MAZOPT0089=Claim site
MAZOPT0090=Field '%1' must be filled in.
MAZOPT0091=Claims worked on in the last 30 days
MAZOPT0092=Claims with follow up date (next 7 days)
MAZOPT0093=Appeal date
MAZOPT0094=Timely filing date
MAZOPT0095=Active claims by payor type
MAZOPT0096=HM Claims of last 30 days with notes or action list page maintain
MAZOPT0097=HM Claims of last 30 days with notes or action list page view
MAZOPT0098=HM Claims of next 7 days with follow up date list page maintain
MAZOPT0099=HM Claims of next 7 days with follow up date list page view
MAZOPT0100=Claim agent goal tracker
MAZOPT0101=Billed region
MAZOPT0102=Next follow-up date can only be less then or equal to
MAZOPT0103=Target count
 ;Goal target count on agent for goal tracker agent graph
MAZOPT0104=Claims with no actions (30 days)
MAZOPT0105=Claims with no actions/notes 7+ days
MAZOPT0106=Related claim prioritization
MAZOPT0107=Do you want to assign other unassigned claims with the same patient, payor and pool automatically ?
MAZOPT0108=unassigned claims of same patient, payor and pool have been assigned to you.
MAZOPT0109=Are you sure you want to deactivate this user? When deactivating a user, all claims will be unassigned, and the collections team member would be deleted.
 ;Label for disabling user who is agent on user form.
MAZOPT0110=Record already in disable queue.
ModifiedFieldName=Modified field name
ModifierTmp=Modifier
NegativeValNotAllowed=Negative values are not allowed
NewLabel1=HMRevenue category table entity view
NewLabel10=adjudica
NewLabel2= 
NewLabel3=New Text
NewLabel4=Hmclaimline
NewLabel5=New Text
NewLabel6=This entity fetch user id which is not active more than 90 days
 ;Developer documentation
NewLabel7=This entity fetches enable user id's and their assigned privileges
 ;Developer documentation
NewLabel8=Active user list export entity view
NewLabel9=Active user list view
NewPriority=New Priority id
NoCaseWarning=Form must be called with case argument
NoRecordSelection=No record has been selected
Notes=Comments
NumberOfDays=Number of days
OldPriority=Old priority id
OtherClaimsOfThePatient=Other claims of the patient
OtherCoverageCodeDescription=Other coverage code description
OutOfRangeWarning=The update number sequence  should be greater than or equal to 1.00, or less than or equal to %1, %2
PaymentPosted=Payment posted
PaymentPostedAmount=Payment posted amount
PaymentPostedDate=Payment posted date
PharmacyServiceTypeDescriptions=Pharmacy service type description
PlaceOfResidenceDescription=Place of residence description
PleaseSelectValidCollectionAgentErrorMsg=Please select valid collection agent
PoolDoesnotExistErrorMsg=Specified pool does not exist. Please select a valid pool.
PoolMustBeSelectedErrorMsg=Pool must be selected
PriorityDoesNotExistErrorMsg=Specified priority does not exist. Please enter a valid priority.
PriorityMustBeSelected=Priority must be selected
PriorityStrategyDoesNotExistErrorMsg=Specified priority strategy does not exist. Please enter a valid priority strategy.
PriorityStrategyForDefaultPriorityFailed=Assignment of priority strategy for default priority on claims is failed
PriorityStrategyMustBeSelected=Priority strategy must be selected
ProductServiceIDQualifierDescription=Product service id qualifier description
ReasonCodeMustBeSelected=Reason code must be selected
ReasonCodeMustBeSelectedErrorMsg=Reason code must be selected
ReasonCodeNotExistErrorMsg=Specified reason code does not exist. Please select a valid reason code.
RecordAlreadyExistError=The %1 status record is already exists for the claim : %2.
RecordNotExists=The associated record doesn't exist in related table %1
RecordUpdated=Record(s) updated successfully
RefreshCharts=Refresh chart(s)
RelationshipCodeDescription=Relationship code description
Reset=Reset
ResetCriteria=Reset criteria
ResetMessage=Message already sent cannot be reset
ResetPoolCriteriaMsg=Are you sure you want to reset the existing pool criteria for Pool: %1?
RouteOfAdministrationDescription=Route of administration description
RxOriginCodeDescription=Rx origin code description
SearchCompleted=Action completed
ShowLogs=Show logs
StagingDataViewPrivilege=Staging Data View
 ;Label for Privilege Staging Data view
TimelyFilingLimit=Timely filing limit
TotalAdjustedAmount=Total adjusted amount
TotalBalanceAmount=Total balance amount
TotalClaimAmount=Total claim amount
TotalPaidAmount=Total paid amount
TransToClaim=Trans To Claim #
UBO4Description=UB04 source description
UCCharge=U/C charge
UHCClaimLineValidateErrorMsg1=The value %1: %2, %3: %4, and %5: %6 does not exist on claim lines against %7: %8.
UHCClaimLineValidateErrorMsg2=The value %1: %2 and %3: %4 does not exist on claim lines against %5: %6.
UHCClaimLineValidateErrorMsg3=The value %1: %2 does not exist on claim lines against %3 %4.
UHCClaimLineValidateErrorMsg4=The value %1: %2 and the combination of %3: %4 and %5: %6 does not exist on claim lines against %7: %8.
UHCClaimLineValidateErrorMsg5=%1: %2 and %3: %4
UHCClaimLineValidateErrorMsg6=, %1: %2 and %3: %4
UHCClaimLineValidateErrorMsg7=The combination of %1: %2, %3: %4, and %5: %6 does not exist on claim lines against %7: %8.
UHCClaimLineValidateErrorMsg8=The combination of %1 does not exist on claim lines against %2: %3.
UHCUniqueId=UHC unique id
UnableToAssingPriorityToClaimID=Unable to assign priority to claim id %
UnableToDeleteClaimPriority=Claim id: %1, Unable to delete data from  temp table having same priority
UnableToSwapPriority=Unable to swap priority
UnableToUpdatePriorityAgainstClaimId=Unable to update priority against claim id %1
UnableToUpdateSequenceNo=Unable to change sequence number
UniqueID=Unique Id
UnitDoseIndictatorDescription=Unit dose indictator description
UpdateClaimCacheFieldDescriptionConfirmationMsg=Would you like to proceed with updating the description, which will also update cached fields on forms associated with the claims?
UpdateClaimCacheFieldsConfirmationMsg=Would you like to proceed with updating the name, which will also update cached fields on forms associated with the claims?
UpdateClaimCacheFieldStatusConfimrationMsg=Would you like to proceed with updating the patient status, which will also update cached fields on forms associated with the claims?
UpdateLogHeaderCountBatchJobFailed=Update record count to log header failed: %1
UpdatePriorityToClaimPoolMultipleThreadTask=Update priority to claim multiple thread task#%1
UpdatePriorityToZeroClaimPoolMultipleThreadTask=Update priority to $0 denied claim multiple thread task#%1
UpdateZeroClaimBatchJobLogsHeaderCount=Update Batch Job Log header count for $0 denied claim
ValueNotFoundInTableError=The value '%1' in field '%2' is not found in the related table '%3'.
ViewClaim=View
 ;Label for button on other claims grid
ViewClaims=View claims
ViewClaimsV2Entity=View claims V2 entity
WaystarUniqueId=Waystar unique id
WellSkyAPIReset=Reset wellsky api
WorkedClaim=Worked claim
wrongInputWarning=The update number sequence  should be greater than or equal to 1.00.
ZeroClaimAgeCalculateMultipleThreadBatchJobs=$0 Denied Claim Age Calculate Multiple Thread Batch Jobs
ZeroClaimBatchJobLogID=Zero Claim batch job log ID
